---------------
|S    |   |   |
| --- | ----  | 
| |   |     | |
| |   |---- |Z|
|   | |     | |
| |   |  |  | |
| | |    |    |
---------------